***************
*       S     *
*** ******* * *
*   *     *   *
* * ***** *** *
* *  *  F * * *
* **** **** * *
*      *      *
***************